111111111111111111111
1x0000000000000000001
101101101101101101101
101101101101101101101
100000000000000000001
101101101101101101101
101101101101101101101
100000000000000000001
101101101101101101101
101101101101101101101
100000000000000000001
101101101101101101101
101101101101101101101
100000000000000000001
101101101101101101101
101101101101101101101
100000000000000000001
101101101101101101101
101101101101101101101
100000000000000000001
111111111111111111111