111111111111
1x0000000001
101101101101
101101101101
100000000001
101101101101
101101101101
100000000001
101101101101
101101101101
100000000001
111111111111